####      B########
     ##############
#### ##############
#### ##############
####     ##########
###### ############
             ######
 ##################
           ########
 ##################
                  A
