B##################
     ##############
#### ##############
#### ##############
####     ##########
###### ############
             ######
########## ########
A          ########
###################
